7 15
|-------------|
|F.....P.....F|
|.-.--.-.----.|
....P..F..P....
|.--.---.----.|
|......@......|
|-------------|